attribute	harmonized
collection date	collection_date
estimated_size	estimated_size
host	host
lat_lon	lat_lon
biome	env_broad_scale
feature	env_local_scale
investigation_type	investigation_type
host taxid	host_taxid
project_name	project_name
geo_loc_name	geo_loc_name
source_mat_id	source_material_id
material	env_medium
ref_biomaterial	ref_biomaterial
num_replicons	num_replicons
isol_growth_condt	isol_growth_condt
env_package	env_package
strain	strain
isolation-source	isolation_source
culture-collection	culture_collection
sub_species	sub_species
specific host	host
investigation type	investigation_type
environmental package	env_package
subsrc_note	subsrc_note
sex	sex
developmental stage	dev_stage
Salinity	salinity
Temperature	temp
Nitrate	nitrate
Phosphate	phosphate
collection_date	collection_date
clone-lib	clone_lib
Strain	strain
depth	depth
substrain	substrain
cultivar	cultivar
nat-host	host
collection-date	collection_date
country	geo_loc_name
lat lon	lat_lon
tissue	tissue
population	population
Family ID	family_id
Relationship	family_relationship
Super Population Code	super_population_code
Population Description	population_description
Super Population Description	super_population_description
culture_collection	culture_collection
family_id	family_id
bio_material	bio_material
isolate	isolate
tissue-type	tissue
sample_type	sample_type
biotic_relationship	biotic_relationship
Diseases	disease
rel_to_oxygen	rel_to_oxygen
trophic_level	trophic_level
biovar	biovar
STRAIN	strain
cell-line	cell_line
ecotype	ecotype
Sex	sex
env_biome	env_broad_scale
env_feature	env_local_scale
env_material	env_medium
isolation_source	isolation_source
salinity	salinity
temperature	temp
Age	age
Collection Year	collection_date
Geographic Origin	geo_loc_name
cell_line	cell_line
Sample name	sample_name
geographic location (country and/or sea,region)	geo_loc_name
isolation source	isolation_source
serovar	serovar
environment (biome)	env_broad_scale
environment (feature)	env_local_scale
environment (material)	env_medium
orgmod_note	orgmod_note
geographic location (country and/or sea, region)	geo_loc_name
relationship	family_relationship
cell line	cell_line
variety	variety
host sex	host_sex
Type Strain	type_strain
Host Name	host
age	age
gender	sex
genotype	genotype
biomaterial provider	biomaterial_provider
cell type	cell_type
treatment	treatment
teleomorph	teleomorph
morphology	morphology
development stage	dev_stage
lat-lon	lat_lon
specific-host	host
Source of Isolate	isolation_source
Depth	depth
Dissolved Oxygen	diss_oxygen
pH	ph
Turbidity	turbidity
Chlorophyll	chlorophyll
Ammonium	ammonium
Silicate	silicate
Fluorescence	fluor
Oxygen	oxygen
collected_by	collected_by
breed	breed
developmental_stage	dev_stage
sample_name	sample_name
pathovar	pathovar
geographic location	geo_loc_name
DISEASE	disease
BIOMATERIAL_PROVIDER	biomaterial_provider
SEX	sex
body_site	tissue
source_name	source_name
GENDER	sex
AGE	age
cell-type	cell_type
totn	tot_nitro
conductivity	conduc
Total Nitrogen	tot_nitro
Total Phosphorus	tot_phosp
Density	density
Alkalinity	alkalinity
Chloride	chloride
Dissolved Organic Carbon	diss_org_carb
geographic_location	geo_loc_name
methane	methane
sulfate	sulfate
chloride	chloride
Humidity	humidity
organic matter	org_matter
Wind Speed	wind_speed
Pressure	pressure
Air Temperature	air_temp
dev_stage	dev_stage
biomaterial_provider	biomaterial_provider
Phaeopigments	phaeopigments
bacterial_production	bac_prod
Dissolved Inorganic Carbon	diss_inorg_carb
Dissolved Organic Nitrogen	diss_org_nitro
CELL_TYPE	cell_type
family ID	family_id
cell l ine	cell_line
Collection date	collection_date
tissue type	tissue
specimen_voucher	specimen_voucher
gap_accession	gap_accession
submitter handle	submitter_handle
biospecimen repository	biospecimen_repository
study name	study_name
biospecimen repository sample id	biospecimen_repository_sample_id
submitted sample id	submitted_sample_id
submitted subject id	submitted_subject_id
gap_sample_id	gap_sample_id
gap_subject_id	gap_subject_id
histological type	histological_type
subject is affected	subject_is_affected
gap_consent_code	gap_consent_code
gap_consent_short_name	gap_consent_short_name
Sample Name	sample_name
tissue/development stage	dev_stage
development point	dev_stage
sample type	sample_type
host_sex	host_sex
host_age	host_age
dominant hand	dominant_hand
host_taxon_id	host_taxid
agent	compound
elevation	elev
description	description
Collection Date	collection_date
ammonium	ammonium
chlorophyll	chlorophyll
density	density
nitrate	nitrate
org_carb	org_carb
org_nitro	org_nitro
organism_count	organism_count
oxy_stat_samp	oxy_stat_samp
phosphate	phosphate
silicate	silicate
temp	temp
tot_depth_water_col	tot_depth_water_col
samp_collect_device	samp_collect_device
samp_mat_process	samp_mat_process
samp_size	samp_size
tissue_type	tissue
DONOR_SEX	sex
TISSUE_TYPE	tissue
genotype/variation	genotype
dev stage	dev_stage
Country	geo_loc_name
cell_lines	cell_line
phenotype	phenotype
Description	description
Cell line	cell_line
study design	study_design
body site	tissue
analyte type	analyte_type
is tumor	is_tumor
bio-material	bio_material
host_disease	host_disease
BODYSITE	tissue
subclone	subclone
Experimental factor	experimental_factor
Host	host
Tissue	tissue
cells	cell_line
Sampling_date	collection_date
Cells	cell_line
ploidy	ploidy
DevelopmentalStage	dev_stage
OrganismPart	tissue
component_organism	component_organism
organ	tissue
KARYOTYPE	karyotype
sample collection date	collection_date
host ID	host_taxid
Geographic Location	geo_loc_name
Host ID	host_taxid
compound	compound
dose	dose
body_product	body_product
family_relationship	family_relationship
samp_store_temp	samp_store_temp
label	label
cell	cell_line
Disease	disease
Year isolated	collection_date
pregnancy	pregnancy
geographic location (country)	geo_loc_name
serogroup	serogroup
Geographic origin	geo_loc_name
Serogroup	serogroup
subsp.	sub_species
treatment protocol	treatment
forma	forma
host_species	host
geographic_origin	geo_loc_name
subsp	sub_species
geographic location (latitude and longitude)	lat_lon
project name	project_name
isolation and growth condition	isol_growth_condt
number of replicons	num_replicons
reference for biomaterial	ref_biomaterial
serotype	serotype
karyotype	karyotype
dev-stage	dev_stage
source tissue	tissue
sampling date	collection_date
CellLine	cell_line
host_subject_id	host_subject_id
host_taxid	host_taxid
race	race
developmental stages	dev_stage
study disease	study_disease
molecular data type	molecular_data_type
Biotic relationship	biotic_relationship
Host taxon ID	host_taxid
Pathogenicity	pathogenicity
Relationship to oxygen	rel_to_oxygen
Trophic level	trophic_level
Source material identifiers	source_material_id
Time of sample collection	collection_date
Geographic location	geo_loc_name
SAMPLE DESCRIPTION	description
geographic location (country and/or sea)	geo_loc_name
specific_host	host
host health state	host_health_state
dissolved organic carbon	diss_org_carb
mean annual and seasonal precipitation	annual_season_precpt
nitrite	nitrite
sample collection device or method	samp_collect_device
Conductivity	conduc
calcium	calcium
extreme_unusual_properties/heavy metals method	heavy_metals_meth
potassium	potassium
redox potential	redox_potential
sample material processing	samp_mat_process
CellType	cell_type
Population	population
Developmental Stage	dev_stage
Host Organism	host
Host Taxonomy ID	host_taxid
Culture Collection	culture_collection
BodyHabitat	body_habitat
BodySite	tissue
GeographicLocation	geo_loc_name
HostSex	host_sex
HostSpecies	host
HostTaxonId	host_taxid
SampleDate	collection_date
Treatment	treatment
BodyProduct	body_product
HOST_TAXID	host_taxid
cell_type	cell_type
CULTIVAR	cultivar
DEVELOPMENTAL STAGE	dev_stage
Soil Type	soil_type
host_status	host_health_state
collection_year	collection_date
StrainOrLine	strain
IHMC ethnicity	ethnicity
antibiotic regimen	antibiotic_regm
body habitat	body_habitat
disease stage	disease_stage
special diet	special_diet
Sample size	samp_size
Soil type	soil_type
Geographical location (lat_lon)	lat_lon
alkalinity	alkalinity
experimental factor	experimental_factor
substrate	substrate
SEROVAR	serovar
disease state	disease
cell lineage	cell_line
Water content of soil	water_content_soil
Storage conditions	store_cond
subtype	subtype
BMI	body_mass_index
Gender	sex
Breed	breed
growth protocol	growth_protocol
type_strain	type_strain
DiseaseState	disease
Experimental Factor: Sex	sex
Phenotype	phenotype
Mating type	mating_type
Genotype	genotype
diet	diet
host body temperature	host_body_temp
host common name	host
life stage	life_stage
sample storage duration	samp_store_dur
sample storage location	samp_store_loc
sample storage temperature	samp_store_temp
host name	host
host taxon id	host_taxid
disease	disease
Sample storage duration	samp_store_dur
geographic location (Country)	geo_loc_name
host tax-id	host_taxid
Host (scientific name)	host
height or length	height_or_length
host color	host_color
host subject id	host_subject_id
pooling of DNA extracts (if done)	pool_dna_extracts
Sample Size	samp_size
oxygen	oxygen
geographical location (longitude and longitude)	lat_lon
infra_specific_name	infra_specific_name
miscellaneous parameter	misc_param
collected-by	collected_by
Isolation and growth condition	isol_growth_condt
Observed biotic relationship	biotic_relationship
history/previous land use	previous_land_use
mean annual and seasonal temperature	annual_season_temp
relationship to oxygen	rel_to_oxygen
geographic origin	geo_loc_name
host species	host
Host Species	host
affection_status	affection_status
lab-host	lab_host
Isolate	isolate
DEVELOPMENTAL_STAGE	dev_stage
Current land use	cur_land_use
Environmental package	env_package
Investigation type	investigation_type
Project name	project_name
Sample collection device or method	samp_collect_device
bromide	bromide
diss_hydrogen	diss_hydrogen
ph	ph
magnesium	magnesium
disease status	disease
Tot-N	tot_nitro
Disease_State	disease
host status	host_health_state
diss_oxygen	diss_oxygen
fluorescence	fluor
diss_org_carb	diss_org_carb
part_org_nitro	part_org_nitro
Development stage	dev_stage
Elevation	elev
Environment (biome)	env_broad_scale
Environment (feature)	env_local_scale
Environment (material)	env_medium
Geographic location (country:region,area)	geo_loc_name
Geographic location (latitude and longitude)	lat_lon
air temperature regimen	air_temp_regm
climate environment	climate_environment
infra_specific_rank	infra_specific_rank
plant body site	plant_body_site
watering regimen	watering_regm
Family_ID	family_id
family_ID	family_id
relationship_type	family_relationship
special_diet	special_diet
Subspecies	sub_species
subspecies	sub_species
mating-type	mating_type
Cell Type	cell_type
host_organism	host
lab_host	lab_host
Sample type	sample_type
Sample collection_date	collection_date
host_taxon_ID	host_taxid
identified-by	identified_by
geographic location (latitude and                     longitude)	lat_lon
geographic location (country and/or                     sea,region)	geo_loc_name
Carbon dioxide	carb_dioxide
Development Stage	dev_stage
Sample material processing	samp_mat_process
developmental stage/cell type	cell_type
family relationship	family_relationship
tissue origin	tissue
tissue/cell type	cell_type
composite design/sieving (if any)	sieving
petroleum hydrocarbon	petroleum_hydrocarb
sub-species	sub_species
organism count	organism_count
Host organism	host
history/flooding	flooding
soil_taxonomic/FAO classification	fao_class
total nitrogen	tot_nitro
total organic carbon	tot_org_carb
TISSUE	tissue
child_of	child_of
Geographical location (country:region, location)	geo_loc_name
ethnicity	ethnicity
specimen-voucher	specimen_voucher
Tissue type	tissue
Geographical location	geo_loc_name
Pooling of DNA extracts (if done)	pool_dna_extracts
Storage conditions (fresh/frozen/other)	store_cond
HOST	host
isolate_name_alias	isolate_name_alias
Outbreak	outbreak
part_org_carb	part_org_carb
alt	altitude
encoded_traits	encoded_traits
altitude	altitude
experimental_factor	experimental_factor
aminopeptidase_activity	aminopept_act
bacterial_carbon_production	bacteria_carb_prod
diether_lipids	diether_lipids
dissolved_carbon_dioxide	diss_carb_dioxide
dissolved_hydrogen	diss_hydrogen
dissolved_organic_carbon	diss_org_carb
dissolved_oxygen	diss_oxygen
chemical_administration	chem_administration
alkyl_diethers	alkyl_diethers
bishomohopanol	bishomohopanol
biomass	biomass
glucosidase_activity	glucosidase_act
organic_nitrogen	org_nitro
mean_friction_velocity	mean_frict_vel
mean_peak_friction_velocity	mean_peak_frict_vel
nitrogen	nitro
oxygenation_status_of_sample	oxy_stat_samp
particle_classification	particle_class
particulate_organic_carbon	part_org_carb
n-alkanes	n_alkanes
organic_carbon	org_carb
organic_matter	org_matter
perturbation	perturbation
porosity	porosity
pressure	pressure
redox_potential	redox_potential
sample_storage_duration	samp_store_dur
sample_storage_location	samp_store_loc
sample_storage_temperature	samp_store_temp
petroleum_hydrocarbon	petroleum_hydrocarb
phospholipid_fatty_acid	phosplipid_fatt_acid
phaeopigments	phaeopigments
sulfide	sulfide
total_carbon	tot_carb
total_organic_carbon	tot_org_carb
turbidity	turbidity
water_content	water_content
miscellaneous_parameter	misc_param
total_nitrogen	tot_nitro
cell line specifics	cell_line
Cell type	cell_type
host organism	host
colection date	collection_date
Body product	body_product
Body site	tissue
Disease status	disease
Experimental Factor	experimental_factor
Geographic location (country and/or sea,region)	geo_loc_name
Host common name	host
Host subject id	host_subject_id
Host taxID	host_taxid
Investigation Type	investigation_type
gastrointestinal tract disorder	gastrointest_disord
disease/cell type	cell_type
organic carbon	org_carb
cultivar_acc	cultivar
Disease stage	disease_stage
clone	clone
dissolved oxygen	diss_oxygen
Sampling date	collection_date
growth media	growth_med
tissue-lib	tissue_lib
body product	body_product
gravidity	gravidity
host disease	host_disease
collected by	collected_by
cultivar/accession	cultivar
tissue/dev_stage	dev_stage
host-disease	host_disease
reference_material	reference_material
sample name	sample_name
humidity	humidity
light intensity	light_intensity
total carbon	tot_carb
disease_stat	disease
genetic variation	genotype
authority	authority
carbon/nitrogen ratio	carb_nitro_ratio
current vegetation	cur_vegetation
storage conditions (fresh/frozen/other)	store_cond
total N	tot_nitro
water content of soil	water_content_soil
dissolved inorganic carbon	diss_inorg_carb
extreme_unusual_properties/heavy metals	heavy_metals
isolate-name-alias	isolate_name_alias
geo-loc-name	geo_loc_name
sample-type	sample_type
Colection Date	collection_date
Environment (Biome)	env_broad_scale
Environment (Feature)	env_local_scale
Geographic location (country)	geo_loc_name
Geographic location (locality)	geo_loc_name
Isolation source	isolation_source
Material	env_medium
Water content	water_content
current land use	cur_land_use
link to climate information	link_climate_info
chemical administration	chem_administration
Diet	diet
sample gender	sex
cell lines	cell_line
passage history	passage_history
dissolved_organic_nitrogen	diss_org_nitro
tidal_stage	tidal_stage
lab host	lab_host
propagation	propagation
tot_phosp	tot_phosp
tot_diss_nitro	tot_diss_nitro
tot_nitro	tot_nitro
carb_dioxide	carb_dioxide
subspecific genetic lineage	subspecf_gen_lin
host_body_product	host_body_product
host_tissue_sampled	host_tissue_sampled
host_genotype	host_genotype
total_dissolved_nitrogen	tot_diss_nitro
sodium	sodium
tissue/cell lines	cell_line
host_phenotype	host_phenotype
sample size	samp_size
source material identifiers	source_material_id
family_role	family_relationship
Race	race
Karyotype	karyotype
Ethnicity	ethnicity
observed biotic relationship	biotic_relationship
encoded traits	encoded_traits
estimated size	estimated_size
extrachromosomal elements	extrachrom_elements
host specificity or range	host_taxid
known pathogenicity	pathogenicity
Geographic location (latitude, longitude)	lat_lon
organism part	tissue
celll line	cell_line
isolation_year	collection_date
host-sex	host_sex
Lat_Lon	lat_lon
body_habitat	body_habitat
host_common_name	host
Geographic location (Country)	geo_loc_name
isolate source	isolation_source
last meal	last_meal
soil type	soil_type
strain id	strain
smoker	smoker
outbreak	outbreak
birth date	birth_date
water content	water_content
sub-strain	substrain
environmental_package	env_package
elev	elev
sample_size	samp_size
cur_vegetation	cur_vegetation
annual_season_precpt	annual_season_precpt
annual_season_temp	annual_season_temp
microbial_biomass_meth	microbial_biomass_meth
microbial_biomass	microbial_biomass
soil_type	soil_type
fao_class	fao_class
store_cond	store_cond
tot_n	tot_nitro
tot_org_carb	tot_org_carb
water_content_soil	water_content_soil
light_intensity	light_intensity
nose/mouth/teeth/throat disorder	nose_mouth_teeth_throat_disord
host-tissue-sampled	host_tissue_sampled
Specific_host	host
total depth of water column	tot_depth_water_col
Methane	methane
horizon	horizon
local_class	local_class
tiss_cult_growth_med	tiss_cult_growth_med
health-state	health_state
Tissue Type	tissue
Environment (Material)	env_medium
Date of Collection	collection_date
pathogenicity	pathogenicity
cell line/clone	cell_line
sample description	description
cellType	cell_type
NARMS isolate number	narms_isolate_number
subspecf_gen_lin	subspecf_gen_lin
ph_meth	ph_meth
water_content_soil_meth	water_content_soil_meth
cur_land_use	cur_land_use
anamorph	anamorph
reactor_type	reactor_type
host-age	host_age
passage-history	passage_history
host-disease-stage	host_disease_stage
host-disease-outcome	host_disease_outcome
host-health-state	host_health_state
health_disease_stat	health_state
host_diet	host_diet
heavy_metals_meth	heavy_metals_meth
heavy_metals	heavy_metals
extreme_salinity	extreme_salinity
agrochem_addition	agrochem_addition
crop_rotation	crop_rotation
ihmc_ethnicity	ethnicity
total phosphorus	tot_phosp
dry mass	dry_mass
pH method	ph_meth
forma_specialis	forma_specialis
plant_body_site	plant_body_site
host_body_habitat	host_body_habitat
misc_param	misc_param
Compound	compound
Dose	dose
host_scientific_name	host
tot_mass	tot_mass
nitro	nitro
gastrointest_disord	gastrointest_disord
type status	type_status
repository	repository
culture collection	culture_collection
risk group	risk_group
Serovar	serovar
wastewater_type	wastewater_type
previous_land_use	previous_land_use
Pathotype	pathotype
host_body_temp	host_body_temp
samp_store_loc	samp_store_loc
host_last_meal	host_last_meal
host_life_stage	host_life_stage
pre-treatment	pre_treatment
Isolation Source	isolation_source
sub_strain	substrain
organism_part	tissue
current vegetation method	cur_vegetation_meth
history/agrochemical additions	agrochem_addition
history/crop rotation	crop_rotation
history/extreme events	extreme_event
history/previous land use method	previous_land_use_meth
soil type method	soil_type_meth
Temp	temp
total organic C method	tot_org_c_meth
host scientific name	host
forma-specialis	forma_specialis
identified_by	identified_by
extrachrom_elements	extrachrom_elements
host_spec_range	host_taxid
image_file	image_file
host-description	host_description
subgroup	subgroup
development_stage	dev_stage
sample_description	description
Geo_loc_name	geo_loc_name
disease-stage	disease_stage
mating_type	mating_type
mating type	mating_type
cell  line	cell_line
Collection_date	collection_date
isolate name alias	isolate_name_alias
cur_vegetation_meth	cur_vegetation_meth
sieving	sieving
tissue -type	tissue
Microbial biomass	microbial_biomass
n_alkanes	n_alkanes
samp_store_dur	samp_store_dur
petroleum_hydrocarb	petroleum_hydrocarb
sediment_type	sediment_type
Sample collection date	collection_date
haplotype	haplotype
foetal_health_stat	foetal_health_stat
gestation_state	gestation_state
air_temp_regm	air_temp_regm
pathotype	pathotype
sewage_type	sewage_type
sludge_retent_time	sludge_retent_time
tisssue	tissue
host_description	host_description
specimen voucher	specimen_voucher
health state	health_state
agrochem addition	agrochem_addition
pooling of DNA extracts	pool_dna_extracts
texture	texture
flooding	flooding
disease_stage	disease_stage
liver disorder	liver_disord
host_occupation	host_occupation
sewage type	sewage_type
wastewater type	wastewater_type
ArrayExpress-StrainOrLine	strain
ArrayExpress-Sex	sex
host diet	host_diet
primary_treatment	primary_treatment
health_state	health_state
sediment type	sediment_type
previous_land_use_meth	previous_land_use_meth
link_climate_info	link_climate_info
local_class_meth	local_class_meth
Serotype	serotype
Label	label
host_disease_outcome	host_disease_outcome
passage_history	passage_history
Previous land use	previous_land_use
soiltype	soil_type
Organic matter	org_matter
is_tumor	is_tumor
host age	host_age
Cell	cell_line
chem_administration	chem_administration
liver_disord	liver_disord
medic_hist_perform	medic_hist_perform
samp_salinity	samp_salinity
host_family_relationship	host_family_relationship
host_height	host_height
host_pulse	host_pulse
host_tot_mass	host_tot_mass
tot_org_c_meth	tot_org_c_meth
tot_carb	tot_carb
bacteria_carb_prod	bacteria_carb_prod
sample_collection_date	collection_date
current	water_current
Altitude	altitude
Sample Type	sample_type
Sampling Date	collection_date
Sample Sex	sex
host_disease_stage	host_disease_stage
fertilizer regimen	fertilizer_regm
pool_dna_extracts	pool_dna_extracts
pet_farm_animal	pet_farm_animal
weight_loss_3_month	weight_loss_3_month
drug_usage	drug_usage
ProjectName	project_name
component organism	component_organism
water content of soil method	water_content_soil_meth
Sulfide	sulfide
BIOMATERIAL PROVIDER	biomaterial_provider
dissolved inorganic nitrogen	diss_inorg_nitro
dissolved inorganic phosphorus	diss_inorg_phosp
dissolved organic nitrogen	diss_org_nitro
twin_sibling_presence	twin_sibling
cell subtype	cell_subtype
diss_inorg_carb	diss_inorg_carb
oxygenation status of sample	oxy_stat_samp
reactor type	reactor_type
Biome	env_broad_scale
bmi	body_mass_index
host_tax_id	host_taxid
Cell Line	cell_line
wind_speed	wind_speed
host_health_state	host_health_state
Sample description	description
MatingType	mating_type
host growth conditions	host_growth_cond
climate_environment	climate_environment
host_growth_cond	host_growth_cond
lifestage	life_stage
profile_position	profile_position
subsrc-note	subsrc_note
host_color	host_color
IHMC medication code	ihmc_medication_code
body-mass index	body_mass_index
Sample_Type	sample_type
medical history performed	medic_hist_perform
biomaterial	bio_material
Host Age	host_age
Host Gender	host_sex
body_mass_index	body_mass_index
height_or_length	height_or_length
Latitude and longitude	lat_lon
tissue_lib	tissue_lib
Growth_protocol	growth_protocol
diss_org_nitro	diss_org_nitro
Analyte Type	analyte_type
Cultivar	cultivar
host_body_site	host_tissue_sampled
Total nitrogen	tot_nitro
celltype	cell_type
life_stage	life_stage
Cell_line	cell_line
nose_mouth_teeth_throat_disord	nose_mouth_teeth_throat_disord
Ploidy	ploidy
strain or line	strain
Sample Description	description
org_matter	org_matter
Porosity	porosity
sample_Type	sample_type
Smoker	smoker
Family Id	family_id
MATING TYPE	mating_type
wind_direction	wind_direction
drainage_class	drainage_class
tot_n_meth	tot_n_meth
carb_nitro_ratio	carb_nitro_ratio
Sample-type	sample_type
Host_name	host
tissuetype	tissue
host_hiv_stat	host_hiv_stat
sub strain	substrain
Substrate	substrate
development stages	dev_stage
Isolation_source	isolation_source
growth_med	growth_med
disease_state	disease
extreme_event	extreme_event
fire	fire
host_id	host_taxid
biochem_oxygen_dem	biochem_oxygen_dem
chem_oxygen_dem	chem_oxygen_dem
Biotic Relationship	biotic_relationship
total N method	tot_n_meth
mineral_nutr_regm	mineral_nutr_regm
humidity_regm	humidity_regm
season_environment	season_environment
watering_regm	watering_regm
secondary_treatment	secondary_treatment
CULTURE_COLLECTION	culture_collection
COLLECTED_BY	collected_by
COUNTRY	geo_loc_name
SUB_SPECIES	sub_species
ISOLATE	isolate
COLLECTION_DATE	collection_date
ISOLATION_SOURCE	isolation_source
SEROTYPE	serotype
LAT_LON	lat_lon
LAB_HOST	lab_host
IDENTIFIED_BY	identified_by
SUB SPECIES	sub_species
sample salinity	samp_salinity
Sample_Description	description
Sulfate	sulfate
host-subject-id	host_subject_id
salinity_meth	salinity_meth
slope_aspect	slope_aspect
horizon_meth	horizon_meth
al_sat	al_sat
tillage	tillage
texture_meth	texture_meth
slope_gradient	slope_gradient
link_class_info	link_class_info
soil_type_meth	soil_type_meth
al_sat_meth	al_sat_meth
host_substrate	host_substrate
Feature	env_local_scale
suspend_part_matter	suspend_part_matter
suspend_solids	suspend_solids
Identified_by	identified_by
subsource_note	subsrc_note
pre_treatment	pre_treatment
host_body_mass_index	host_body_mass_index
nat_host	host
Geographic_origin	geo_loc_name
birth_location	birth_location
death_date	death_date
growth_protocol	growth_protocol
sub species	sub_species
environment_biome	env_broad_scale
cell_subtype	cell_subtype
strain_id	strain
host body product	host_body_product
birth_date	birth_date
breeding_history	breeding_history
breeding_method	breeding_method
stud_book_number	stud_book_number
host_shape	host_shape
collectiondate	collection_date
geographic location (country and/or sea region)	geo_loc_name
host_infra_specific_name	host_infra_specific_name
PH	ph
history/tillage	tillage
link to classification information	link_class_info
links to additional analysis	link_addit_analys
death date	death_date
Host_length	host_length
host_blood_press_diast	host_blood_press_diast
host_blood_press_syst	host_blood_press_syst
host_dry_mass	host_dry_mass
host_infra_specific_rank	host_infra_specific_rank
diss_carb_dioxide	diss_carb_dioxide
Pre-treatment	pre_treatment
isolatename_alias	isolate_name_alias
Investigation_type	investigation_type
tot_phosphate	tot_phosphate
pH_meth	ph_meth
pulmonary_disord	pulmonary_disord
blood_blood_disord	blood_blood_disord
Life_stage	life_stage
Geographical_location	geo_loc_name
Collection_Date	collection_date
total mass	tot_mass
environment biome	env_broad_scale
atmospheric_data	atmospheric_data
Haplotype	haplotype
Biovar	biovar
source_material_id	source_material_id
Culture_collection	culture_collection
fungicide_regm	fungicide_regm
chemical oxygen demand	chem_oxygen_dem
samp_vol_we_dna_ext	samp_vol_we_dna_ext
bodySite	tissue
host_length	host_length
conduc	conduc
indust_eff_percent	indust_eff_percent
emulsions	emulsions
diss_inorg_nitro	diss_inorg_nitro
diss_inorg_phosp	diss_inorg_phosp
gaseous_substances	gaseous_substances
Environmental Package	env_package
Project Name	project_name
fluor	fluor
hiv_stat	hiv_stat
pretreatment	pre_treatment
barometric_press	barometric_press
biomaterial-provider	biomaterial_provider
Mating_type	mating_type
isolate_name	isolate
rel_air_humidity	rel_air_humidity
abs_air_humidity	abs_air_humidity
heat_cool_type	heat_cool_type
space_typ_state	space_typ_state
ventilation_type	ventilation_type
building_setting	building_setting
typ_occupant_dens	typ_occupant_dens
indoor_space	indoor_space
filter_type	filter_type
occup_samp	occup_samp
build_occup_type	build_occup_type
air_temp	air_temp
occupant_dens_samp	occupant_dens_samp
light_type	light_type
isolate name	isolate
ArrayExpress-Phenotype	phenotype
efficiency_percent	efficiency_percent
type_status	type_status
clone_lib	clone_lib
antibiotic_regm	antibiotic_regm
inorg_particles	inorg_particles
org_particles	org_particles
soluble_inorg_mat	soluble_inorg_mat
soluble_org_mat	soluble_org_mat
tertiary_treatment	tertiary_treatment
aminopept_act	aminopept_act
bac_prod	bac_prod
bac_resp	bac_resp
down_par	down_par
glucosidase_act	glucosidase_act
mean_frict_vel	mean_frict_vel
mean_peak_frict_vel	mean_peak_frict_vel
phosplipid_fatt_acid	phosplipid_fatt_acid
photon_flux	photon_flux
primary_prod	primary_prod
soluble_react_phosp	soluble_react_phosp
tot_inorg_nitro	tot_inorg_nitro
tot_part_carb	tot_part_carb
water_current	water_current
sample_ type	sample_type
diseasestatus	disease
samplename	sample_name
Host disease	host_disease
orgmod-note	orgmod_note
Subtype	subtype
Subgroup	subgroup
SampleType	sample_type
geo loc name	geo_loc_name
dermatology_disord	dermatology_disord
host body habitat	host_body_habitat
host body site	host_tissue_sampled
host family relationship	host_family_relationship
host genotype	host_genotype
host infra-specific name	host_infra_specific_name
particle_class	particle_class
fertilizer_regm	fertilizer_regm
herbicide_regm	herbicide_regm
sample volume or weight for DNA extraction	samp_vol_we_dna_ext
chem_mutagen	chem_mutagen
gaseous_environment	gaseous_environment
gravity	gravity
growth_hormone_regm	growth_hormone_regm
host_wet_mass	host_wet_mass
mechanical_damage	mechanical_damage
non_mineral_nutr_regm	non_mineral_nutr_regm
pesticide_regm	pesticide_regm
ph_regm	ph_regm
plant_product	plant_product
radiation_regm	radiation_regm
rainfall_regm	rainfall_regm
salt_regm	salt_regm
standing_water_regm	standing_water_regm
water_temp_regm	water_temp_regm
Type Status	type_status
Collection Date 	collection_date
Risk Group	risk_group
Geo_Loc_Name	geo_loc_name
env biome	env_broad_scale
env feature	env_local_scale
env material	env_medium
Collected_by	collected_by
tidal stage	tidal_stage
Environment biome	env_broad_scale
Environment Feature	env_local_scale
Environment material	env_medium
Geo loc name	geo_loc_name
Lat lon	lat_lon
latitude_and_longitude	lat_lon
environment_material	env_medium
environment_feature	env_local_scale
indoor_surf	indoor_surf
dew_point	dew_point
host_ID	host_taxid
ArrayExpress-Genotype	genotype
ArrayExpress-DevelopmentalStage	dev_stage
ArrayExpress-CellType	cell_type
ArrayExpress-DiseaseState	disease
ArrayExpress-Compound	compound
ArrayExpress-Dose	dose
ArrayExpress-OrganismPart	tissue
ArrayExpress-Treatment	treatment
collectedby	collected_by
devstage	dev_stage
sampletype	sample_type
samp_sort_meth	samp_sort_meth
ventilation_rate	ventilation_rate
bodysite	tissue
dominanthand	dominant_hand
familyid	family_id
subsource note	subsrc_note
Environment feature	env_local_scale
environment material	env_medium
Developmental stage	dev_stage
environment biome 	env_broad_scale
host phenotype	host_phenotype
Soil_type	soil_type
WaterContent	water_content
host_gender	host_sex
growth_media	growth_med
Lat_lon	lat_lon
Biomaterial Provider	biomaterial_provider
latitude and longitude	lat_lon
env-feature	env_local_scale
env-material	env_medium
environment feature	env_local_scale
family id	family_id
family role	family_relationship
annual season temp	annual_season_temp
host_disease_stat	host_disease
Magnesium	magnesium
isolation_and_growth_condition	isol_growth_condt
Derived from	derived_from
diseases	disease
TREATMENT	treatment
Nitrite	nitrite
Particulate Organic Carbon	part_org_carb
Particulate Organic Nitrogen	part_org_nitro
history/fire	fire
slope aspect	slope_aspect
slope gradient	slope_gradient
soil_taxonomic/local classification	local_class
host last meal	host_last_meal
host life stage	host_life_stage
Host status	host_health_state
sample_date	collection_date
trophic level	trophic_level
derived-from	derived_from
identified by	identified_by
birth_control	birth_control
douche	douche
gynecologic_disord	gynecologic_disord
hrt	hrt
hysterectomy	hysterectomy
ihmc_medication_code	ihmc_medication_code
menarche	menarche
menopause	menopause
sexual_act	sexual_act
urogenit_disord	urogenit_disord
Host taxid	host_taxid
host height	host_height
host total mass	host_tot_mass
absolute air humidity	abs_air_humidity
air temperature	air_temp
building occupancy type	build_occup_type
building setting	building_setting
carbon dioxide	carb_dioxide
filter type	filter_type
heating and cooling system type	heat_cool_type
indoor space	indoor_space
light type	light_type
occupancy at sampling	occup_samp
occupant density at sampling	occupant_dens_samp
relative air humidity	rel_air_humidity
space typical state	space_typ_state
typical occupant density	typ_occupant_dens
ventilation type	ventilation_type
isol_growth_condt 	isol_growth_condt
last_meal	last_meal
occupation	occupation
Geographic_location	geo_loc_name
number_of_replicons	num_replicons
reference_for_biomaterial	ref_biomaterial
Isolate name alias	isolate_name_alias
submitter-asserted type strain	type_strain
Latitude and Longitude	lat_lon
Growth protocol	growth_protocol
cell  type	cell_type
isolate_source	isolation_source
sludge retention time	sludge_retent_time
reference material	reference_material
Variety	variety
molecular_data_type	molecular_data_type
cell lline	cell_line
Fire	fire
Collected By	collected_by
Disease Status	disease
biological material	bio_material
time_last_toothbrush	time_last_toothbrush
NARMS_isolate_number	narms_isolate_number
breeding history	breeding_history
breeding method	breeding_method
collection year	collection_date
Sample_description	description
Env_biome	env_broad_scale
Env_feature	env_local_scale
Chemical administration	chem_administration
Fertilizer regimen	fertilizer_regm
bacterial production	bac_prod
particle classification	particle_class
ArrayExpress-Age	age
geographical location	geo_loc_name
Ecotype	ecotype
Biomaterial_provider	biomaterial_provider
Body_Site	tissue
analyte_type	analyte_type
 subsp	sub_species
beta_lactamase_family	beta_lactamase_family
carbapenemase	carbapenemase
edta_inhibitor_tested	edta_inhibitor_tested
Isolate_source	isolation_source
Organ	tissue
disease_status	disease
derived from	derived_from
Year_isolated	collection_date
Biomaterial provider	biomaterial_provider
dominant_hand	dominant_hand
env package	env_package
environment material 	env_medium
Type status	type_status
growth-protocol	growth_protocol
travel_out_six_month	travel_out_six_month
plant product	plant_product
Sub Species	sub_species
Total_organic_carbon	tot_org_carb
Specimen voucher	specimen_voucher
surf_material	surf_material
geographic location (countryand/orsea,region)	geo_loc_name
Source Name	source_name
mean friction velocity	mean_frict_vel
mean peak friction velocity	mean_peak_frict_vel
aminopeptidase activity	aminopept_act
dermatology disorder	dermatology_disord
organic nitrogen	org_nitro
suspended particulate matter	suspend_part_matter
total dissolved nitrogen	tot_diss_nitro
hiv status	hiv_stat
dry_mass	dry_mass
wet_mass	wet_mass
link_addit_analys	link_addit_analys
source name	source_name
image file	image_file
soil_taxonomic/fao classification	fao_class
Sub species	sub_species
RACE	race
host disease outcome	host_disease_outcome
Population_description	population_description
source_mat-id	source_material_id
Project_name	project_name
host id	host_taxid
development  stage	dev_stage
ref biomaterial	ref_biomaterial
rel to oxygen	rel_to_oxygen
samp collect device	samp_collect_device
samp mat process	samp_mat_process
samp size	samp_size
source material id	source_material_id
total_N	tot_nitro
DiseaseStage	disease_stage
SamplingDate	collection_date
body mass index	body_mass_index
source of isolate	isolation_source
TEMPERATURE	temp
DevelopmentStage	dev_stage
COMPOUND	compound
DOSE	dose
FamilyRelationship	family_relationship
FamilyID	family_id
GeneticVariation	genotype
Subclone	subclone
CellLineage	cell_line
Morphology	morphology
BodyMassIndex	body_mass_index
Same As	same_as
PLOIDY	ploidy
total_n	tot_nitro
Sample_type	sample_type
sub-type	subtype
CellSubType	cell_subtype
birth location	birth_location
same as	same_as
host_BMI	host_body_mass_index
child of	child_of
treatment 	treatment
Host age	host_age
bio material	bio_material
birthdate	birth_date
Bio-material	bio_material
surfacematerial	surf_material
Organic Carbon	org_carb
Organic Matter	org_matter
Calcium	calcium
Potassium	potassium
Sodium	sodium
Total  Nitrogen	tot_nitro
isolationsource	isolation_source
geolocname	geo_loc_name
latlon	lat_lon
refbiomaterial	ref_biomaterial
reltooxygen	rel_to_oxygen
sampcollectdevice	samp_collect_device
sampmatprocess	samp_mat_process
sampsize	samp_size
sourcematerialid	source_material_id
family member	family_relationship
Project_Name	project_name
host_taxID	host_taxid
sample date	collection_date
SampleDescription	description
sampling_date	collection_date
Host_Age	host_age
Host_Gender	host_sex
ph_method	ph_meth
Gravidity	gravidity
strain_ID	strain
pulse	pulse
tot mass	tot_mass
EDTA inhibitor tested	edta_inhibitor_tested
bio-material-provider	biomaterial_provider
stud book number	stud_book_number
cell-subtype	cell_subtype
host_hiv_status	host_hiv_stat
SampleName	sample_name
pollutants	pollutants
Source_material_id	source_material_id
Altitude 	altitude
study_name	study_name
host description	host_description
derived_from	derived_from
Collected by	collected_by
Culture collection	culture_collection
Growth media	growth_med
Host_Sex	host_sex
istumor	is_tumor
Dominant Hand	dominant_hand
Trophic_level	trophic_level
Ph	ph
Analyte type	analyte_type
Env_material	env_medium
Env_package	env_package
Estimated_size	estimated_size
Isol_growth_condt	isol_growth_condt
Num_replicons	num_replicons
Ref_biomaterial	ref_biomaterial
Rel_to_oxygen	rel_to_oxygen
Source_mat_id	source_material_id
sexual activity	sexual_act
birth control	birth_control
source_materialid	source_material_id
re_lto_oxygen	rel_to_oxygen
Medication Code	ihmc_medication_code
Host Sex	host_sex
Host Disease	host_disease
Host Subject Id	host_subject_id
env_broad_scale	env_broad_scale
env_local_scale	env_local_scale
env_medium	env_medium
amniotic_fluid_color	amniotic_fluid_color
lat_loN	lat_lon
donor sex	sex
storage_conditions	store_cond
Growth_media	growth_med
water content soil	water_content_soil
tissue/developmental stage	dev_stage
Nitrogen	nitro
twin_sibling	twin_sibling
host tissue sampled	host_tissue_sampled
Sample_Date	collection_date
current_land_use	cur_land_use
Child Of	child_of
host_HIVStatus	host_hiv_stat
Host_genotype	host_genotype
History/agrochemical additions	agrochem_addition
soil taxonomic/local classification	local_class
soil taxonomic/local classification method	local_class_meth
lat_lo N	lat_lon
host infra-specific rank	host_infra_specific_rank
YEAR_ISOLATED	collection_date
treatment_protocol	treatment
sampleDescription	description
PHENOTYPE	phenotype
Dev-stage	dev_stage
Clone	clone
diet_last_six_month	diet_last_six_month
kidney_disord	kidney_disord
maternal_health_stat	maternal_health_stat
nose_throat_disord	nose_throat_disord
study_complt_stat	study_complt_stat
urine_collect_meth	urine_collect_meth
urogenit_tract_disor	urogenit_tract_disor
Elev	elev
Biotic_relationship	biotic_relationship
Samp_collect_device	samp_collect_device
hiv_status	hiv_stat
particulate organic carbon	part_org_carb
particulate organic nitrogen	part_org_nitro
sampledescription	description
cellline	cell_line
Celltype	cell_type
source mat id	source_material_id
Derived From	derived_from
SoilType	soil_type
infraspecific name	infra_specific_name
Dissolved Inorganic Nitrogen	diss_inorg_nitro
Total Phosphate	tot_phosphate
Soiltype	soil_type
isolate_name-alias	isolate_name_alias
host body-mass index	host_body_mass_index
Treatment 	treatment
ArrayExpress-STRAIN_OR_LINE	strain
SAMPLENAME	sample_name
heavy_ metals	heavy_metals
st-rain	strain
host gender	host_sex
envbiome	env_broad_scale
envfeature	env_local_scale
envmaterial	env_medium
isolgrowthcondt	isol_growth_condt
hostage	host_age
hostsex	host_sex
Disease_Stage	disease_stage
genotype / variation	genotype
Family_member	family_relationship
Pretreatment	pre_treatment
host 	host
phenotype 	phenotype
 sub species	sub_species
subspecies 	sub_species
HIV_status	hiv_stat
Type strain	type_strain
organism modifier note	orgmod_note
host substrate	host_substrate
observed_biotic_relationship	biotic_relationship
Isolation-Source	isolation_source
Collection-Date	collection_date
BIOME	env_broad_scale
DEPTH	depth
FEATURE	env_local_scale
MATERIAL	env_medium
dissolved hydrogen	diss_hydrogen
host BMI	host_body_mass_index
hostgender	host_sex
isolation   source	isolation_source
collection   date	collection_date
geo   loc   name	geo_loc_name
lat   lon	lat_lon
chemical mutagen	chem_mutagen
Biomaterial_Provider	biomaterial_provider
BiomaterialProvider	biomaterial_provider
Geographic_Location	geo_loc_name
Development_stage	dev_stage
sample__name	sample_name
Dissolved oxygen	diss_oxygen
time_since_last_wash	time_since_last_wash
ArrayExpress-SEX	sex
broad-scale environmental context	env_broad_scale
local-scale environmental context	env_local_scale
forma specialis	forma_specialis
Collected_By	collected_by
Isolation_Source	isolation_source
Host_age	host_age
sample_collection device or method	samp_collect_device
sub_type	subtype
host_subject_ID	host_subject_id
Sample storage location	samp_store_loc
Sample storage temperature	samp_store_temp
Passage history	passage_history
Isolate Name	isolate
isol growth condt	isol_growth_condt
num replicons	num_replicons
mineral nutrient regimen	mineral_nutr_regm
Year_Isolated	collection_date
environmental medium	env_medium
Body_site	tissue
Sample_date	collection_date
Study Name	study_name
Host sex	host_sex
pre treatment	pre_treatment
seasonal environment	season_environment
host_name	host
trophiclevel	trophic_level
suspended solids	suspend_solids
Host_gender	host_sex
Host_ID	host_taxid
type-strain	type_strain
total_mass	tot_mass
_temp	temp
secondary treatment	secondary_treatment
host length	host_length
cell sub-type	cell_subtype
ELEVATION	elev
ENV_BIOME	env_broad_scale
ENV_FEATURE	env_local_scale
ENV_MATERIAL	env_medium
env_broad_range	env_broad_scale
env_local_range	env_local_scale
total particulate carbon	tot_part_carb
geographic _location	geo_loc_name
donor_sex	sex
sub-group	subgroup
strain 	strain
culture-collection 	culture_collection
Growth Media	growth_med
primary treatment	primary_treatment
Broad scale environmental context	env_broad_scale
Environmental medium	env_medium
Number of replicons	num_replicons
Reference for biomaterial	ref_biomaterial
Broad Scale Environmental Context	env_broad_scale
Environmental Medium	env_medium
Carbon_dioxide	carb_dioxide
ALT	altitude
Disease State	disease
environment_(biome)	env_broad_scale
environment_(feature)	env_local_scale
environment_(material)	env_medium
storage_conditions_(fresh/frozen/other)	store_cond
host_total_mass	host_tot_mass
biospecimen_repository	biospecimen_repository
biospecimen_repository_sample_id	biospecimen_repository_sample_id
study_design	study_design
submitted_sample_id	submitted_sample_id
submitted_subject_id	submitted_subject_id
submitter_handle	submitter_handle
study_disease	study_disease
subject_is_affected	subject_is_affected
absolute_air_humidity	abs_air_humidity
air_temperature	air_temp
carbon_dioxide	carb_dioxide
heating_and_cooling_system_type	heat_cool_type
occupancy_at_sampling	occup_samp
occupant_density_at_sampling	occupant_dens_samp
relative_air_humidity	rel_air_humidity
typical_occupant_density	typ_occupant_dens
GEOGRAPHIC_LOCATION	geo_loc_name
biotic relationship	biotic_relationship
geoloc_name	geo_loc_name
environmental_medium	env_medium
Host Genotype	host_genotype
Host Diet	host_diet
ArrayExpress-PHENOTYPE	phenotype
substructure_type	substructure_type
surf_air_cont	surf_air_cont
surf_humidity	surf_humidity
surf_moisture	surf_moisture
surf_moisture_ph	surf_moisture_ph
surf_temp	surf_temp
experimental   factor	experimental_factor
source of uvigs	source_uvig
virus enrichment approach	virus_enrich_appr
tissue_origin	tissue
Specific_Host	host
LifeStage	life_stage
Reference for Biomaterial	ref_biomaterial
Sample Collection Device or Method	samp_collect_device
Sample Material Processing	samp_mat_process
Sample_storage_temperature	samp_store_temp
size_frac	size_frac
source_uvig	source_uvig
virus_enrich_appr	virus_enrich_appr
Mating Type	mating_type
drug usage	drug_usage
Host_disease	host_disease
dev_ stage	dev_stage
sample_name-	sample_name
source-material-id	source_material_id
host_bmi	host_body_mass_index
bacterial respiration	bac_resp
omics_observ_id	omics_observ_id
relationship_to_oxygen	rel_to_oxygen
broad-scale_environmental_context	env_broad_scale
local-scale_environmental_context	env_local_scale
indoor surface	indoor_surf
Dissolved_oxygen	diss_oxygen
Total_phosphorus	tot_phosp
Total_nitrogen	tot_nitro
disease  state	disease
sampledate	collection_date
Broad-scale environmental context	env_broad_scale
Local-scale environmental context	env_local_scale
organic particles	org_particles
profile position	profile_position
salinity method	salinity_meth
biomaterialprovider	biomaterial_provider
local_scale_environmental_context	env_local_scale
Birth location	birth_location
Breeding history	breeding_history
Breeding method	breeding_method
BirthDate	birth_date
Total_carbon	tot_carb
total n	tot_nitro
experimental-factor	experimental_factor
Host BMI	host_body_mass_index
Source_material_ID	source_material_id
Reactor Type	reactor_type
broad_scale_environmental_context	env_broad_scale
ArrayExpress-CELL_TYPE	cell_type
ArrayExpress-ORGANISM_PART	tissue
ArrayExpress-DEVELOPMENTAL_STAGE	dev_stage
geographical_location	geo_loc_name
Birthdate	birth_date
type strain	type_strain
HostID	host_taxid
samp-collect-device	samp_collect_device
samp-mat-process	samp_mat_process
Perturbation	perturbation
Host life stage	host_life_stage
Host body product	host_body_product
Host body habitat	host_body_habitat
ArrayExpress-GENOTYPE	genotype
ArrayExpress-DISEASE_STATE	disease
ArrayExpress-COMPOUND	compound
ArrayExpress-DOSE	dose
ArrayExpress-AGE	age
ArrayExpress-TREATMENT	treatment
Bio_material	bio_material
organism strain	strain
building_occupancy_type	build_occup_type
surface_material	surf_material
indoor_surface	indoor_surf
Height or length	height_or_length
texture method	texture_meth
source_material_ID	source_material_id
Life Stage	life_stage
_env_broad_scale	env_broad_scale
_env_local_scale	env_local_scale
_env_medium	env_medium
_isolate	isolate
source_of_uvigs	source_uvig
Light intensity	light_intensity
specimen_voucher_	specimen_voucher
date_of_collection	collection_date
Geographic  Location	geo_loc_name
Health_State	health_state
tertiary treatment	tertiary_treatment
gynecological disorder	gynecologic_disord
Collection_year	collection_date
hostid	host_taxid
study_Name	study_name
Health State	health_state
project-name	project_name
env broad scale	env_broad_scale
env local scale	env_local_scale
env medium	env_medium
resp_part_matter	resp_part_matter
HIV status	hiv_stat
geographic location (locality)	geo_loc_name
Is Tumor	is_tumor
time_of_sample_collection	collection_date
Isolation_year	collection_date
Estimated size	estimated_size
population_description	population_description
cell t ype	cell_type
host_ sex	host_sex
Host Tissue sampled	host_tissue_sampled
Study name	study_name
isolate_name alias	isolate_name_alias
source of UViGs	source_uvig
projectname	project_name
sampleType	sample_type
soil_taxonomic/local classification method	local_class_meth
BREED	breed
pesticide_regimen	pesticide_regm
presence of pets or farm animals	pet_farm_animal
travel outside the country in last six months	travel_out_six_month
dissolved carbon dioxide	diss_carb_dioxide
ETHNICITY	ethnicity
HEALTH STATE	health_state
SAMPLE TYPE	sample_type
sampleName	sample_name
host infra specific name	host_infra_specific_name
host body mass index	host_body_mass_index
year isolated	collection_date
soil taxonomic/fao classification	fao_class
humidity regimen	humidity_regm
mechanical damage	mechanical_damage
